0 0 0 0 0 0 0 0
0 1 2 2 2 2 1 0
0 1 3 12 3 1 1 0
0 1 3 4 3 3 1 0
0 1 4 61 4 4 1 0
0 0 0 0 0 0 0 0