0 0 0 0 0 0 0 0 0 0 0 0 0 0 0 0 0 0 0 0 0 0 0 0 0 0 0
0 1 1 1 7 1 1 1 1 1 1 1 1 1 1 1 3 1 1 1 1 1 1 1 1 1 0
0 1 1 6 6 6 1 1 1 1 1 1 1 1 1 1 1 1 1 1 1 1 1 1 1 1 0
0 1 1 6 6 6 1 1 1 1 1 1 1 1 1 1 3 1 1 1 1 1 1 1 1 1 0
0 1 1 1 1 1 1 1 1 1 1 1 1 1 1 1 3 1 1 1 1 1 1 1 1 1 0
0 1 1 1 1 1 1 1 1 1 1 1 3 3 1 1 1 1 1 1 1 1 1 1 1 1 0
0 1 1 1 1 1 1 1 1 1 1 1 3 3 1 1 1 1 1 1 1 1 1 1 1 1 0
0 1 1 1 1 1 1 1 1 1 1 1 1 1 1 1 1 1 1 8 9 10 1 1 1 1 0
0 1 1 1 1 1 1 1 1 1 1 1 3 3 1 1 1 1 1 11 12 13 1 1 1 1 0
0 1 1 1 1 1 1 1 1 1 1 1 3 3 1 1 1 1 1 14 15 16 1 1 1 1 0
0 1 1 1 1 1 1 1 1 1 1 1 1 1 1 1 3 1 1 1 1 1 1 1 1 1 0
0 1 1 1 1 1 1 1 1 1 1 1 1 1 1 1 3 3 3 3 3 1 1 1 1 1 0
0 1 1 1 1 1 1 1 1 1 1 1 1 3 3 1 1 1 3 3 3 3 1 1 1 1 0
0 1 1 1 1 1 1 1 1 1 1 1 3 3 1 1 1 1 1 1 1 3 1 1 1 1 0
0 1 1 1 1 1 1 1 1 1 1 1 1 1 1 1 1 1 1 1 1 3 3 1 1 1 0
0 1 1 1 1 1 1 1 1 1 1 1 1 1 1 1 1 1 1 1 1 1 1 4 4 4 0
0 1 1 1 1 1 1 1 1 1 1 1 1 1 1 1 1 1 4 4 5 4 5 4 5 5 0
0 1 1 1 1 1 1 1 1 1 7 1 1 1 1 1 1 1 5 3 3 3 4 5 5 5 0
0 1 1 1 1 1 1 1 1 1 1 1 1 1 1 1 1 1 4 3 3 3 3 3 3 3 0
0 0 0 0 0 0 0 0 0 0 0 0 0 0 0 0 0 0 0 0 0 0 0 0 0 0 0

2 0 4 1
2 0 4 2
0 0 4 3
0 0 3 3
0 0 5 3
1 0 5 2
1 0 3 2

2 1 10 17
1 1 10 16
0 1 11 17
2 1 12 7
0 1 13 7
0 1 18 6
0 1 18 7
0 1 18 8