0 0 0 0 0 0 0 0 0 0 0 0 0 0 0 0 0 0 0 0 0 0 0 0 0 0 0
0 1 1 1 1 1 3 3 1 1 1 1 1 1 3 3 3 6 6 6 6 8 9 10 6 3 0
0 1 1 1 1 1 3 3 1 1 1 3 3 3 3 3 3 6 6 1 1 11 12 13 6 3 0
0 1 1 1 1 1 3 3 1 1 3 3 3 3 3 3 1 1 1 1 1 14 15 16 6 3 0
0 1 1 1 1 1 1 1 1 1 1 3 3 3 3 3 1 1 1 1 1 1 1 1 6 3 0
0 3 3 3 3 3 1 1 1 1 1 1 3 3 3 1 1 1 6 6 6 6 6 6 6 3 0
0 3 3 3 3 3 1 1 1 1 1 1 1 1 1 1 1 1 3 3 3 3 3 3 3 3 0
0 1 1 1 1 1 1 1 1 1 1 1 1 1 1 1 1 1 3 3 3 3 3 3 3 3 0
0 1 1 1 1 1 1 1 1 1 1 1 1 1 1 1 1 1 1 1 1 1 1 1 1 1 0
0 1 1 1 1 1 1 1 1 1 1 1 1 1 1 1 1 1 1 1 1 1 1 1 1 1 0
0 5 1 1 1 1 1 1 1 1 1 1 1 2 2 2 1 1 1 1 1 1 1 1 1 1 0
0 5 1 1 1 1 5 4 4 1 1 1 1 1 2 2 2 1 1 1 1 1 1 1 1 1 0
0 5 5 1 1 1 5 4 4 1 1 1 1 1 1 2 2 2 1 1 1 1 1 1 1 1 0
0 2 2 1 1 5 5 4 4 1 1 1 1 1 1 1 2 2 2 1 1 1 1 1 1 1 0
0 6 6 1 1 6 6 2 4 1 1 1 1 1 1 1 1 2 2 2 1 1 1 1 1 1 0
0 6 1 1 1 1 6 2 4 1 1 1 1 1 1 1 1 1 2 2 2 1 1 1 1 1 0
0 6 1 7 7 1 6 1 1 1 1 1 1 1 1 1 1 1 1 2 2 2 1 4 4 4 0
0 6 1 7 7 1 6 1 1 1 1 1 1 1 1 1 1 1 4 4 5 4 5 4 5 5 0
0 6 1 1 1 1 6 2 4 1 1 1 1 1 1 1 1 1 5 3 3 3 4 5 5 5 0
0 6 6 6 6 6 6 2 4 1 1 1 1 1 1 1 1 1 4 3 3 3 3 3 3 3 0
0 0 0 0 0 0 0 0 0 0 0 0 0 0 0 0 0 0 0 0 0 0 0 0 0 0 0

2 0 1 14
2 0 1 15
2 0 2 14
2 0 5 14
2 0 6 15
2 0 6 14
1 0 1 16
1 0 1 17
1 0 1 18
1 0 6 16
1 0 6 17
1 0 6 18
0 0 1 19
0 0 2 19
0 0 3 19
0 0 4 19
0 0 5 19
0 0 6 19

2 1 18 5
2 1 19 5
2 1 20 5
2 1 21 5
2 1 22 5
2 1 23 5
1 1 18 1
1 1 18 2
1 1 17 1
1 1 17 2
1 1 19 1
1 1 20 1
0 1 24 1
0 1 24 2
0 1 24 3