0 0 0 0 0 0 0 0 0 0 0 0 0 0 0 0 0 0 0 0 0 0 0 0 0 0 0
0 2 1 1 1 1 1 1 1 1 1 1 1 1 1 1 1 1 1 1 1 1 1 1 1 2 0
0 1 1 1 1 1 1 1 1 1 1 1 1 1 1 1 1 1 1 1 1 1 1 1 1 1 0
0 4 4 4 4 4 4 4 4 4 4 4 1 1 1 1 1 1 1 1 1 1 1 1 1 1 0
0 2 2 2 2 2 2 2 2 2 2 2 4 1 1 1 1 1 1 1 1 1 1 1 1 1 0
0 2 2 2 2 2 2 2 2 2 2 2 4 1 1 1 1 1 1 1 1 1 1 1 1 1 0
0 6 6 6 6 6 6 6 6 6 2 2 4 1 1 1 1 1 1 1 1 1 1 1 1 1 0
0 6 19 19 19 19 19 19 19 6 2 2 4 1 1 1 1 1 1 1 1 1 1 1 1 1 0
0 6 19 19 19 19 19 19 19 6 2 2 4 1 1 1 1 1 1 1 1 1 1 1 1 1 0
0 6 19 19 8 9 10 19 19 18 18 18 1 1 1 1 1 1 1 1 1 1 1 1 1 1 0
0 6 19 19 11 12 13 19 19 18 18 18 1 1 1 1 1 1 1 1 1 1 1 1 1 1 0
0 6 19 19 14 15 16 19 19 18 18 18 1 1 1 1 1 1 1 1 1 1 1 1 1 1 0
0 6 19 19 19 19 19 19 19 6 2 2 4 1 1 1 1 1 1 1 1 1 1 1 1 1 0
0 6 19 19 19 19 19 19 19 6 2 2 4 1 1 1 1 1 1 1 1 1 1 1 1 1 0
0 6 6 6 6 6 6 6 6 6 2 2 4 1 1 1 1 1 1 1 1 1 1 1 1 1 0
0 2 2 2	2 2 2 2	2 2 2 2 4 1 1 1 1 1 1 1 1 1 1 1 1 1 0
0 2 2 2 2 2 2 2 2 2 2 2 4 1 1 1 1 1 1 1 1 1 1 1 1 1 0
0 4 4 4 4 4 4 4 4 4 4 4 1 1 1 1 1 1 1 1 1 1 1 1 1 1 0
0 1 1 1 1 1 1 1 1 1 1 1 1 1 1 1 1 1 1 1 1 1 1 1 1 1 0
0 2 1 1 1 1 1 1 1 1 1 1 1 1 1 1 1 1 1 1 1 1 1 1 1 2 0
0 0 0 0 0 0 0 0 0 0 0 0 0 0 0 0 0 0 0 0 0 0 0 0 0 0 0

0 0 2 7
0 0 2 8
0 0 3 7
0 0 3 8 
0 0 3 12
0 0 3 13
0 0 2 12
0 0 2 13
1 0 6 7
1 0 7 7
1 0 6 8
1 0 7 8
1 0 6 12
1 0 7 13
1 0 6 13
1 0 7 12
2 0 8 9
2 0 8 10
2 0 8 11
